{
    "compose_ids": [
        134257216, 
        134268943, 
        134233952, 
        134244701, 
        134280428, 
        201390095, 
        201390094, 
        201390093, 
        201390091, 
        201390090, 
        201390089, 
        201390087, 
        201390088, 
        201390085, 
        201390086, 
        201390081, 
        201390082, 
        134245059, 
        134238903, 
        201390083, 
        201390084, 
        201390096, 
        201390097, 
        134278589, 
        134257065, 
        134264126, 
        134253385, 
        134243995, 
        134267045, 
        134275213, 
        134278629, 
        134280087, 
        134218218, 
        134262923, 
        134262215, 
        134233763, 
        134255180, 
        134224775, 
        134218624, 
        134221867, 
        134240232, 
        134257384, 
        134234796, 
        134229235, 
        134253920, 
        134275099, 
        134273700, 
        201390092, 
        134258256, 
        134276637, 
        134269247, 
        134250786, 
        134257230, 
        134250168, 
        134233693, 
        134277246, 
        201390023, 
        201390024, 
        201390001, 
        201390002, 
        134245520, 
        134253209, 
        134266379, 
        134240669, 
        134280991, 
        134253458, 
        134275201, 
        134260638, 
        134220478, 
        134258902, 
        134259974, 
        134221707, 
        134227374, 
        134247802, 
        134279433, 
        134223031, 
        134235596, 
        134276843, 
        134257654, 
        134234476, 
        134225187, 
        134241336, 
        134264106, 
        134270161, 
        134273866, 
        134236649, 
        134239070, 
        134280633, 
        134264461, 
        134254000, 
        134237585, 
        134227287, 
        134266900, 
        134222530, 
        134249067, 
        134237220, 
        134240703, 
        134240125, 
        134240315, 
        134237275, 
        134256747, 
        134268528, 
        134239458, 
        134267063, 
        134248238, 
        134262722, 
        134272297, 
        134280971, 
        134281501, 
        134251309, 
        134223114, 
        134219198, 
        134264715, 
        134277068, 
        134219805, 
        134246980, 
        134232297, 
        134276044, 
        134226968, 
        134272240, 
        134242094, 
        134251639, 
        134269861, 
        134249564, 
        134250758, 
        134239985, 
        134220509, 
        134279852, 
        134277868, 
        134232336, 
        134234176, 
        134244673, 
        134265129, 
        134252610, 
        134234775, 
        134239322, 
        134219976, 
        134220202, 
        134251030, 
        134247738, 
        134254086, 
        134239338, 
        134257692, 
        134275965, 
        134243194, 
        134245693, 
        134226702
    ], 
    "item_id_seed": 3
}